{
    "安徽": {
        "累计确诊": 15,
        "新增确诊": 6,
        "累计治愈": 0,
        "新增治愈": 0,
        "累计死亡": 0,
        "新增死亡": 0
    },
    "澳门": {
        "累计确诊": 2,
        "新增确诊": 1,
        "累计治愈": 0,
        "新增治愈": 0,
        "累计死亡": 0,
        "新增死亡": 0
    },
    "福建": {
        "累计确诊": 5,
        "新增确诊": 4,
        "累计治愈": 0,
        "新增治愈": 0,
        "累计死亡": 0,
        "新增死亡": 0
    },
    "甘肃": {
        "累计确诊": 2,
        "新增确诊": 0,
        "累计治愈": 0,
        "新增治愈": 0,
        "累计死亡": 0,
        "新增死亡": 0
    },
    "广西": {
        "累计确诊": 13,
        "新增确诊": 8,
        "累计治愈": 0,
        "新增治愈": 0,
        "累计死亡": 0,
        "新增死亡": 0
    },
    "贵州": {
        "累计确诊": 3,
        "新增确诊": 0,
        "累计治愈": 0,
        "新增治愈": 0,
        "累计死亡": 0,
        "新增死亡": 0
    },
    "海南": {
        "累计确诊": 8,
        "新增确诊": 4,
        "累计治愈": 0,
        "新增治愈": 0,
        "累计死亡": 0,
        "新增死亡": 0
    },
    "河北": {
        "累计确诊": 2,
        "新增确诊": 1,
        "累计治愈": 0,
        "新增治愈": 0,
        "累计死亡": 1,
        "新增死亡": 1
    },
    "黑龙江": {
        "累计确诊": 4,
        "新增确诊": 2,
        "累计治愈": 0,
        "新增治愈": 0,
        "累计死亡": 1,
        "新增死亡": 1
    },
    "湖北": {
        "累计确诊": 549,
        "新增确诊": 105,
        "累计治愈": 31,
        "新增治愈": 3,
        "累计死亡": 24,
        "新增死亡": 7
    },
    "湖南": {
        "累计确诊": 24,
        "新增确诊": 15,
        "累计治愈": 0,
        "新增治愈": 0,
        "累计死亡": 0,
        "新增死亡": 0
    },
    "吉林": {
        "累计确诊": 3,
        "新增确诊": 2,
        "累计治愈": 0,
        "新增治愈": 0,
        "累计死亡": 0,
        "新增死亡": 0
    },
    "江苏": {
        "累计确诊": 9,
        "新增确诊": 8,
        "累计治愈": 0,
        "新增治愈": 0,
        "累计死亡": 0,
        "新增死亡": 0
    },
    "江西": {
        "累计确诊": 7,
        "新增确诊": 4,
        "累计治愈": 0,
        "新增治愈": 0,
        "累计死亡": 0,
        "新增死亡": 0
    },
    "辽宁": {
        "累计确诊": 4,
        "新增确诊": 2,
        "累计治愈": 0,
        "新增治愈": 0,
        "累计死亡": 0,
        "新增死亡": 0
    },
    "内蒙古": {
        "累计确诊": 1,
        "新增确诊": 1,
        "累计治愈": 0,
        "新增治愈": 0,
        "累计死亡": 0,
        "新增死亡": 0
    },
    "宁夏": {
        "累计确诊": 2,
        "新增确诊": 1,
        "累计治愈": 0,
        "新增治愈": 0,
        "累计死亡": 0,
        "新增死亡": 0
    },
    "青海": {
        "累计确诊": 0,
        "新增确诊": 0,
        "累计治愈": 0,
        "新增治愈": 0,
        "累计死亡": 0,
        "新增死亡": 0
    },
    "山东": {
        "累计确诊": 9,
        "新增确诊": 3,
        "累计治愈": 0,
        "新增治愈": 0,
        "累计死亡": 0,
        "新增死亡": 0
    },
    "山西": {
        "累计确诊": 1,
        "新增确诊": 0,
        "累计治愈": 0,
        "新增治愈": 0,
        "累计死亡": 0,
        "新增死亡": 0
    },
    "陕西": {
        "累计确诊": 5,
        "新增确诊": 2,
        "累计治愈": 0,
        "新增治愈": 0,
        "累计死亡": 0,
        "新增死亡": 0
    },
    "上海": {
        "累计确诊": 20,
        "新增确诊": 4,
        "累计治愈": 0,
        "新增治愈": 0,
        "累计死亡": 0,
        "新增死亡": 0
    },
    "四川": {
        "累计确诊": 15,
        "新增确诊": 7,
        "累计治愈": 0,
        "新增治愈": 0,
        "累计死亡": 0,
        "新增死亡": 0
    },
    "台湾": {
        "累计确诊": 1,
        "新增确诊": 0,
        "累计治愈": 0,
        "新增治愈": 0,
        "累计死亡": 0,
        "新增死亡": 0
    },
    "天津": {
        "累计确诊": 5,
        "新增确诊": 1,
        "累计治愈": 0,
        "新增治愈": 0,
        "累计死亡": 0,
        "新增死亡": 0
    },
    "西藏": {
        "累计确诊": 0,
        "新增确诊": 0,
        "累计治愈": 0,
        "新增治愈": 0,
        "累计死亡": 0,
        "新增死亡": 0
    },
    "香港": {
        "累计确诊": 2,
        "新增确诊": 1,
        "累计治愈": 0,
        "新增治愈": 0,
        "累计死亡": 0,
        "新增死亡": 0
    },
    "新疆": {
        "累计确诊": 2,
        "新增确诊": 2,
        "累计治愈": 0,
        "新增治愈": 0,
        "累计死亡": 0,
        "新增死亡": 0
    },
    "云南": {
        "累计确诊": 2,
        "新增确诊": 1,
        "累计治愈": 0,
        "新增治愈": 0,
        "累计死亡": 0,
        "新增死亡": 0
    },
    "浙江": {
        "累计确诊": 43,
        "新增确诊": 16,
        "累计治愈": 1,
        "新增治愈": 0,
        "累计死亡": 0,
        "新增死亡": 0
    },
    "重庆": {
        "累计确诊": 27,
        "新增确诊": 18,
        "累计治愈": 0,
        "新增治愈": 0,
        "累计死亡": 0,
        "新增死亡": 0
    },
    "北京": {
        "累计确诊": 26,
        "新增确诊": 12,
        "累计治愈": 0,
        "新增治愈": 0,
        "累计死亡": 0,
        "新增死亡": 0
    },
    "河南": {
        "累计确诊": 9,
        "新增确诊": 4,
        "累计治愈": 0,
        "新增治愈": 0,
        "累计死亡": 0,
        "新增死亡": 0
    },
    "广东": {
        "累计确诊": 53,
        "新增确诊": 21,
        "累计治愈": 2,
        "新增治愈": 2,
        "累计死亡": 0,
        "新增死亡": 0
    }
}